[level]
layer_0 = 0000000000
          0000000000
          0000000000
          0000000000
          0000000000
          0000000000
          0000000000
          0000000000
          0000000000
          0000000000
          0000000000
          0000000000

layer_1 = ...000..00
          ...000..00
          ...000....
          ...000....
          ..........
          ..........
          ..........
          ..........
          ...000....
          ...000....
          ...000....
          ..........

layer_2 = 00........
          00........
          ..........
          ..........
          ..........
          ..00000000
          ..00000000
          ....000...
          ..........
          ..........
          ..........
          00......00
          00......00


[stone]
layer = 0
tileset = assets/img/tiles/stone/tilelist.png

[grass]
layer = 1
tileset = assets/img/tiles/grass/tilelist.png

[water]
layer = 2
tileset = assets/img/tiles/water2/tilelist.png
